NO ./textures/wall1.xpm
SO ./textures/wall2.xpm
WE ./textures/wall3.xpm
EA ./textures/wall4.xpm
P ./textures/door.xpm
C0,0,0
F255,255,255

11111
10001
10001
10001
10001
10001
10001
10001
10001
10N01
11111
