
NO ./textures/s1.xpm
SO ./textures/s3.xpm
WE ./textures/s4.xpm
EA ./textures/s2.xpm
P ./textures/door.xpm
C0,0,0
F255,255,255

11111111111
1P0000000P1
10010101111
10001000001
10000P00001
10000000101
10000E00101
11110000111
1P0000000P1
11111111111
