
NO ./textures/s1.xpm
SO ./textures/s3.xpm
WE ./textures/s4.xpm
EA ./textures/s2.xpm

C0,0,0
F255,255,255

11111111111
10000000011
10010101111
10001000001
10000000001
10000000101
10000E00101
11110000111
11000000001
11111111111
