
NO ./textures/wall1.xpm
SO ./textures/wall2.xpm
WE ./textures/wall3.xpm
EA ./textures/wall4.xpm
P ./textures/door.xpm
C 225,30,0
F 220,100,0

        1111111111111111111111111
        1000000000110000000000001
        1011000001110000000000001
        1001000000000000000000001
111111111011000001110000000000001
10000000001100000111011111P111111
11110111111111011100000010001
11110111111111011101010010001
11000000110101011100000010001
10000000000000001100000010001
1000000000000000110101001000111111111111111111111111111
11000001110101011111011110000000000000000000000000000N1
11110111 1110101 1011110100011111111111111111111111P1111
11111111 1111111 111111111111                   11111111
